mackerel	mackerel
yellow	yellow
four	four
hyssop	hyssop
deli	deli
rise	rising,rise
jack	jack
broiler	broiler
tangerin	tangerine
poppi	poppy
frozen	frozen
cholesterol	cholesterol
barbecu	barbecue,barbecued
speck	speck
almond	almond,almonds
bacon	bacon
millet	millet
albacor	albacore
blue	blue
zesti	zesty
beaten	beaten
fingerl	fingerling
beater	beaters
new	new
crunch	crunch
hero	hero
herb	herbs
floret	florets
safflow	safflower
100	100
mozzarella	mozzarella
spreadabl	spreadable
dri	dried,dry
smoke	smoked
aka	aka
golden	golden
straw	straw
homemad	homemade
soybean	soybean,soybeans
jujub	jujube,jujubes
ploy	ploy
blueberri	blueberries,blueberry
spike	spike
cottag	cottage
chervil	chervil
calf	calf
glass	glass
warm	warm
pecan	pecans
holi	holy
95	95
96	96
shoot	shoots
flora	flora
sweeten	sweetened,sweetener,sweeteners
blade	blade
mi	mi
ms	ms
elbow	elbow
oleo	oleo
root	root,roots
vodka	vodka
edibl	edible
honey	honey
pinto	pinto
hog	hog
fondant	fondant
hot	hot,hots
hop	hops
pizza	pizza
lump	lump
salsa	salsa
lap	lap
third	third
croissant	croissant,croissants
fungu	fungus
green	green,greens
wing	wings
wine	wine
carnat	carnation
fettuccin	fettuccine
maraschino	maraschino
couscou	couscous
crumbl	crumbles,crumbled
orang	orange,oranges
oven	oven
caster	caster
digest	digestive
chihuahua	chihuahua
savori	savory
avocado	avocado,avocados
better	better
durum	durum
fig	figs
hidden	hidden
enrich	enriched
promis	promise
bream	bream
wedg	wedges
runni	runny
bread	bread
crock	crock
thyme	thyme
rosemari	rosemary
chuck	chuck
dumpl	dumplings
toffe	toffee
arrow	arrow
meal	meal
bone	bone,bones,boned
hanger	hanger
navi	navy
prawn	prawns
turnip	turnips
extract	extract
marmalad	marmalade
whip	whipping,whipped
jell	jell
velvet	velvet
sand	sanding
re	re
amaranth	amaranth
hothous	hothouse
cassava	cassava
carcass	carcass
free	free
mullet	mullet
angl	angled
raisin	raisins
sprig	sprigs
soda	soda
rang	range
render	rendered
grade	grade
hoop	hoop
thick	thick
spinach	spinach
top	top,topping,tops,toppings
bonito	bonito
tot	tots
ton	ton
tom	tom
gooseberri	gooseberries
bitter	bitters
kiwi	kiwi
luncheon	luncheon
cornflour	cornflour
cereal	cereal
hazelnut	hazelnuts
aquavit	aquavit
sticker	stickers
tree	tree
iron	iron
minut	minute
mini	mini
fashion	fashioned
minc	minced
skinless	skinless
asparagu	asparagus
truffl	truffle,truffles
raw	raw
seed	seeds
miniatur	miniature
seltzer	seltzer
mint	mint
snow	snow
terrin	terrine
hatch	hatch
salsifi	salsify
gravi	gravy
regular	regular
peppercorn	peppercorns
watercress	watercress
tradit	traditional
m	m
dog	dogs
scotch	scotch
sum	sum
littleneck	littleneck
sago	sago
tequila	tequila
sage	sage
fennel	fennel
earth	earth
toast	toasted,toasts
shellfish	shellfish
tamarind	tamarind
sugar	sugar,sugars
bliss	bliss
rich	rich
tropic	tropical
rice	rice
cappuccino	cappuccino
10	10
cheddar	cheddar
chitterl	chitterlings
pocket	pockets
watermelon	watermelon
iceberg	iceberg
relish	relish
earl	earl
glutin	glutinous
bar	bars
pretzel	pretzels
bay	bay
whitefish	whitefish
bag	bags
steak	steak,steaks
steam	steamed
heirloom	heirloom
nut	nuts
sturgeon	sturgeon
wholesom	wholesome
best	best
00	00
lotu	lotus
finger	fingers
yogurt	yogurt
vitamin	vitamin
iodiz	iodized
medallion	medallions
nonfat	nonfat
carbon	carbonated
kitchen	kitchen
eggnog	eggnog
brat	brats
conch	conch
cox	cox
margarin	margarine
cob	cob
cod	cod
linguin	linguine
pita	pita,pitas
pate	pate
bran	bran
con	con
spear	spears
toni	tony
quinc	quinces
beetroot	beetroot
beef	beef
fri	fry,fried,frying,fries
parsley	parsley
chrysanthemum	chrysanthemum
beer	beer
spread	spread
beet	beets
tupelo	tupelo
basil	basil
sprite	sprite
mushroom	mushrooms
snap	snaps
chili	chilies
chill	chilled
balsam	balsamic
cracker	crackers
n	n
lesser	lesser
calcium	calcium
seven	seven
cane	cane,canes
mouss	mousse
sushi	sushi
it	it
cone	cones
hong	hong
belli	belly
camellia	camellia
passov	passover
split	split
wheel	wheels
papaya	papaya
nib	nibs
hand	hand
rais	raising
garlic	garlic
refin	refined
tuna	tuna
butter	butter
endiv	endive
scone	scones
drip	drippings
ocean	ocean
kiwifruit	kiwifruit
kale	kale
bit	bits
alum	alum
ham	ham
royal	royal
collard	collard,collards
cognac	cognac
kelp	kelp
huckleberri	huckleberries
enchilada	enchilada
cherri	cherry,cherries
preserv	preserved,preserves
confection	confectioners
boysenberri	boysenberries
shoulder	shoulder
homini	hominy
old	old
cuisin	cuisine
cayenn	cayenne
orchid	orchid
okra	okra
collect	collect
ice	ice,icing,iced
grapefruit	grapefruit
plantain	plantains
plu	plus
tartar	tartar
peel	peel,peeled
corn	corn,corned
shuck	shuck,shucked
nectarin	nectarines
plum	plum,plums
curri	curry
o	o
dinner	dinner
coars	coarse
octopus	octopuses
allspic	allspice
chutney	chutney
fern	ferns
loin	loin
wrap	wraps
dean	dean
medal	medal
imit	imitation
groundnut	groundnut
wax	wax
gin	gin
head	heads
sorbet	sorbet
farina	farina
marinara	marinara
refriger	refrigerated
beech	beech
true	true
elderflow	elderflower
manioc	manioc
paprika	paprika
crystal	crystal,crystallized
trim	trimmed
shin	shin
classic	classic
petit	petite,petits
cassia	cassia
mole	mole
sticki	sticky
no	no
butterscotch	butterscotch
tip	tip,tips
rotisseri	rotisserie
topsid	topside
venison	venison
tie	tie
whey	whey
roll	roll,rolls,rolled
matur	mature
garland	garland
liquoric	liquorice
diet	diet
ammonium	ammonium
caraway	caraway
potato	potatoes
navel	navel
bottom	bottoms
roe	roe
snip	snip
mild	mild
skate	skate
skim	skim,skimmed
skin	skins,skinned
guava	guava
milk	milk
varnish	varnish
flan	flan
grape	grape,grapes
lemonad	lemonade
flounder	flounder
oz	oz
melon	melon
southwest	southwest
brown	brown,browning,browns
string	string
jerk	jerk
yeast	yeast
vegan	vegan
cook	cooking,cooked
margarita	margarita
nectar	nectar
leftov	leftover
chardonnay	chardonnay
gum	gum
pea	peas
p	p
cooki	cookies
guy	guy
dip	dipping,dips
round	round,rounds
shave	shavings,shaved
pork	pork
bock	bock
shortcrust	shortcrust
currant	currants
crescent	crescent
bake	baking,baked
port	port
jambalaya	jambalaya
fillet	fillet,fillets
unbak	unbaked
gingersnap	gingersnap
water	water
muesli	muesli
boy	boy
baobab	baobab
bow	bow,bows
cinnamon	cinnamon
vinaigrett	vinaigrette
bob	bob
stew	stewed,stewing
extra	extra
radish	radishes
fishcak	fishcake
swerv	swerve
bloodi	bloody
creami	creamy
sake	sake
vineyard	vineyard
cucumb	cucumber,cucumbers
club	club
sparerib	spareribs
beluga	beluga
spearmint	spearmint
prepar	prepared
cap	caps
soup	soup
sour	sour
can	canned
citru	citrus
purpos	purpose
heart	hearts
legum	legumes
chip	chips,chipped
matzo	matzo,matzos
pink	pink
savoy	savoy
winter	winter
pine	pine
1	1
flank	flank
pure	puree
cocktail	cocktail
southern	southern
gelatin	gelatin
brioch	brioche
date	date,dates
crepe	crepes
neck	neck
liquid	liquid
unseason	unseasoned
granari	granary
st	st
mango	mango
comfort	comfort
brais	braising
chickpea	chickpea,chickpeas
cold	cold
cola	cola
sprinkl	sprinkles
muffin	muffins
torn	torn
artisan	artisan
curli	curly
farmer	farmer
gizzard	gizzards
non	non
halv	halves
tentacl	tentacles
half	half
not	not
molass	molasses
ketchup	ketchup
wagon	wagon
stir	stir
oliv	olives
cannelloni	cannelloni
peasant	peasant
hickori	hickory
rock	rock
quarter	quarters
streaki	streaky
el	el
soy	soy
amaretto	amaretto
moonshin	moonshine
sunda	sundae
dutch	dutch
uncl	uncle
nettl	nettle
clover	clover
tempura	tempura
carp	carp
waxi	waxy
yum	yum
pepperoni	pepperoni
silver	silver
origin	original,originals
beverag	beverages
one	one
mignon	mignon
fast	fast
rind	rind
ring	rings
size	size
sheep	sheep
sheet	sheets
unflavor	unflavored
virgin	virgin
hummu	hummus
assort	assorted
2	2
white	white,whites
thaw	thawed
season	seasoning,seasoned,seasons
vermicelli	vermicelli
meringu	meringue
pompano	pompano
butt	butt
than	than
serv	serving
wide	wide
15	15
14	14
balanc	balance
coconut	coconut
pastri	pastry
angel	angel
slaw	slaw
pro	pro
dash	dash
medium	medium
breakfast	breakfast
slab	slab
canton	canton
squab	squabs
mayer	mayer
pain	pain
compress	compressed
butterfli	butterflied
honeydew	honeydew
champagn	champagne
tendon	tendons
seafood	seafood
trotter	trotters
liverwurst	liverwurst
knuckl	knuckle
salt	salt,salted
perch	perch
banger	banger
ginseng	ginseng
glaze	glaze,glazed
calamari	calamari
ground	ground
dice	diced
gourd	gourd
activ	active
sloe	sloe
wood	wood,woods
black	black
helix	helix
sprout	sprouts
pumpkin	pumpkin
porridg	porridge
fatback	fatback
gem	gem
gel	gel
prime	prime
cumin	cumin
bison	bison
tallow	tallow
tortilla	tortillas
kernel	kernel,kernels
picnic	picnic
starchi	starchy
cauliflow	cauliflower
sport	sports
mutton	mutton
whiskey	whiskey
ornament	ornamental
3	3
mandarin	mandarin
turbot	turbot
loofah	loofah
spare	spare
broil	broil
berri	berries
s	s
color	color,coloring
pot	pot,pots
pop	popped
poi	poi,pois
boar	boar
pod	pods
turkey	turkey
jerki	jerky
mark	mark
ravioli	ravioli
tangelo	tangelos
thousand	thousand
rubi	ruby
squash	squash
tiger	tiger
arrowroot	arrowroot
drum	drum
delici	delicious
case	casings
kappa	kappa
imperi	imperial
coca	coca
coco	coco
sorghum	sorghum
sugarcan	sugarcane
parmigiana	parmigiana
strain	strained
protein	protein
cacao	cacao
turmer	turmeric
pat	pat
alphabet	alphabet
parboil	parboiled
nonpareil	nonpareils
macaroni	macaroni
catfish	catfish
lite	lite
grain	grain,grained
pan	pan
oil	oil
nest	nests
weed	weed
fruit	fruit,fruits
lemon	lemon
drain	drain,drained
burrito	burrito
nonstick	nonstick
ranch	ranch
barberri	barberries
veal	veal
shortbread	shortbread
alfalfa	alfalfa
summer	summer
cornbread	cornbread
fume	fume
clot	clotted
steamer	steamer
ch	ch
touch	touch
polish	polish
flavor	flavored,flavoring
concentr	concentrate
cilantro	cilantro
rose	rose
anis	anise
4	4
real	real
grit	grits
ladi	lady
dark	dark
anchovi	anchovy,anchovies
crusti	crusty
world	world
fryer	fryer,fryers
meat	meat,meats
clam	clams
burdock	burdock
leek	leeks
honeysuckl	honeysuckle
claw	claws
breadfruit	breadfruit
dole	dole
lobster	lobster,lobsters
freez	freeze
slice	slices,sliced
tube	tube
moos	moose
teardrop	teardrop
fructos	fructose
squirt	squirt
evapor	evaporated
porter	porter
wheat	wheat
roast	roasted,roasting
zest	zest
stone	stone
of	of
mixer	mixers
side	side,sides
chop	chopped,chops
pistachio	pistachio,pistachios
wolf	wolf
stand	standing
ox	ox
chive	chives
road	road
unsalt	unsalted
amber	amber
marshmallow	marshmallow,marshmallows
strip	strip,strips
jowl	jowl
her	herring
disco	disco
lop	lop
low	low
hen	hens
valley	valley
wholem	wholemeal
bottl	bottled
sorrel	sorrel
burro	burro
unsweeten	unsweetened
groat	groats
treacl	treacle
rusk	rusk
tripl	triple
tripe	tripe
bouillon	bouillon
cornmeal	cornmeal
grass	grass
pulp	pulp
cactu	cactus
russet	russet
gumbo	gumbo
deep	deep
file	file
cultur	cultured
fill	filling,filled
paddl	paddles
reduct	reduction
field	field
5	5
sunflow	sunflower
juic	juice
brandi	brandy
granul	granulated,granules
condens	condensed
pear	pear,pears
submarin	submarine
reduc	reduced
cabbag	cabbage
mash	mashed
alo	aloe
all	all
pheasant	pheasant
ale	ale
escarol	escarole
dish	dish
conger	conger
dairi	dairy
tail	tails
foster	foster
ti	ti
cress	cress
premium	premium
verbena	verbena
fat	fat,fats
baton	baton
crumb	crumbs
hemp	hemp
dinosaur	dinosaur
prosciutto	prosciutto
small	small
farmhous	farmhouse
tel	tel
tea	tea,teas
tricolor	tricolor
past	paste
burger	burger,burgers
zero	zero
waffl	waffle
sub	sub
sun	sun
section	sections
crust	crust,crusts
mesquit	mesquite
crush	crushed
burgundi	burgundy
essenc	essence
full	full
hash	hash
pumpernickel	pumpernickel
strong	strong
rosewat	rosewater
vegetarian	vegetarian
guacamol	guacamole
lasagna	lasagna
chunki	chunky
vie	vie
sherbet	sherbet
shortcak	shortcakes
famili	family
grenadin	grenadine
eye	eyed
rustic	rustic
pearl	pearl,pearls,pearled
garnish	garnish
amontillado	amontillado
chestnut	chestnuts
flat	flat
diamond	diamond
flax	flax
pectin	pectin
stick	sticks
mellow	mellow
uncook	uncooked
grill	grilled,grilling
hous	house
malt	malt,malted
dew	dew
tapioca	tapioca
suckl	suckling
v	v
abalon	abalone
mo	mo
shark	shark
challeng	challenge
firmli	firmly
sharp	sharp
dress	dressing
browni	brownie,brownies
freshli	freshly
rye	rye
mapl	maple
simpl	simple
goat	goat
sandwich	sandwich,sandwiches
blacken	blackening,blackened
blood	blood
absinth	absinthe
a	a
short	short
blackcurr	blackcurrant
dragon	dragon
halibut	halibut
egg	eggs
mission	mission
scrod	scrod
wiener	wieners
paper	paper
dough	dough,doughs
pane	pane
25	25
style	style
sodium	sodium
buttercup	buttercup
boneless	boneless
pad	pad
pesto	pesto
cool	cool
good	good
food	food,foods
goos	goose
nugget	nugget,nuggets
cointreau	cointreau
fulli	fully
fish	fish
hard	hard
heavi	heavy
pralin	praline
energi	energy
orient	oriental
flower	flower,flowers,flowering
alcohol	alcohol
pigeon	pigeon
granola	granola
7	7
arctic	arctic
fiber	fiber
bass	bass
pud	pudding
puf	puffed
cornstarch	cornstarch
base	base,based
believ	believe
acorn	acorn
thread	threads
daisi	daisy
success	success
blossom	blossom,blossoms
corkscrew	corkscrew
feet	feet
calori	calorie
blanc	blanc
razor	razor
gourmet	gourmet
brisket	brisket
scallion	scallions
master	master
syrup	syrup
banana	banana,bananas
store	store
semisweet	semisweet
part	part,parts
flaxse	flaxseed
king	king
tortellini	tortellini
b	b
haddock	haddock
coleslaw	coleslaw
marbl	marble
gala	gala
tandoori	tandoori
blanch	blanched
mountain	mountain
sherri	sherry
self	self
zucchini	zucchini
seedless	seedless
salmon	salmon
mixtur	mixture
lavend	lavender
mace	mace
moss	moss
chard	chard
oyster	oyster,oysters
strawberri	strawberries,strawberry
clear	clear
cover	covered
tongu	tongue
blend	blend,blends
gold	gold
espresso	espresso
redcurr	redcurrant
melt	melted
fine	fine,finely,fines
giant	giant
northern	northern
less	less
8	8
hip	hip
dandelion	dandelion
batter	batter
breast	breasts
fluff	fluff
caramel	caramel,caramels
paella	paella
crosswis	crosswise
marinad	marinade
vine	vine
sec	sec
sea	sea
tender	tenders,tenderizer
bark	bark
guinea	guinea
won	won
wok	wok
jasmin	jasmine
sole	sole
spray	spray
purpl	purple
aspic	aspic
rasher	rashers
sardin	sardines
patti	patties
eggplant	eggplant,eggplants
whole	whole
loaf	loaf
point	points,pointed
sweet	sweet
crispi	crispy
scallop	scallops
loav	loaves
devil	devil,deviled
buttermilk	buttermilk
secret	secret,secrets
firm	firm
fire	fire
leafi	leafy
convert	converted
ginger	ginger
fruitcak	fruitcake
sweetbread	sweetbreads
solid	solid
capsicum	capsicum
straight	straight
pace	pace
ladyfing	ladyfingers
loos	loosely
pack	pack,packed
pound	pound
readi	ready
petal	petals
hibiscu	hibiscus
duckl	ducklings
spong	sponge
centuri	century
quail	quail
muenster	muenster
rib	rib,ribs
chicori	chicory
decor	decorating
shorten	shortening
grand	grand
yucca	yucca
sliver	slivered
snail	snails
island	islands
stripe	striped
pimento	pimentos
lower	lower
sumac	sumac
cheek	cheeks
grind	grind
pickl	pickled,pickles,pickling
chees	cheese
swiss	swiss
crayfish	crayfish
tast	taste
pollen	pollen
cockl	cockles
pomegran	pomegranate
morsel	morsels
shape	shapes
cut	cut,cuts
cup	cups
licoric	licorice
horseradish	horseradish
quick	quick
kumquat	kumquats
silken	silken
rigatoni	rigatoni
big	big
game	game
semolina	semolina
maltos	maltose
blackberri	blackberries,blackberry
spini	spiny
d	d
semi	semi
chow	chow
eel	eel
scape	scape
bamboo	bamboo
honeycomb	honeycomb
spring	spring
creation	creations
back	back
yolk	yolks
palm	palm
falafel	falafel
pale	pale
chocol	chocolate
schmaltz	schmaltz
saltin	saltines
capon	capon
substitut	substitute
larg	large
lard	lard
precook	precooked
needl	needles
muscat	muscat
machin	machine
rum	rum
rub	rubbed
fresco	fresco
raspberri	raspberries,raspberry
stem	stems
squeez	squeezed
beefsteak	beefsteak
oatmeal	oatmeal
canning	canning
block	block
miracl	miracle
tofu	tofu
jimmi	jimmy,jimmies
kielbasa	kielbasa
artifici	artificial
parsnip	parsnips
frost	frosting,frostings
ginkgo	ginkgo
link	links
butteri	buttery
coriand	coriander
apricot	apricot,apricots
up	up
peppermint	peppermint
jumbo	jumbo
dill	dill
char	char
curd	curd,curds
cure	cured,curing
chat	chat
curl	curls
graham	graham
kidney	kidney,kidneys
rainbow	rainbow
taro	taro
peach	peaches
grouper	grouper
saffron	saffron
ferment	fermented
tart	tart
scrub	scrub,scrubbed
mustard	mustard
kaiser	kaiser
fisher	fisher
swede	swede
cuttlefish	cuttlefish
land	land
e	e
wafer	wafers
age	aged
heath	heath
seawe	seaweed
fresh	fresh
buffalo	buffalo
lean	lean
mayonnais	mayonnaise
soften	softened
morel	morel
culinari	culinary
peanut	peanuts
shanghai	shanghai
young	young
granular	granular
starter	starter
junip	juniper
garden	garden
sausag	sausage,sausages
dessert	dessert
ouzo	ouzo
recip	recipe
button	button
quahog	quahog
rack	rack,racks
nestl	nestle
sultana	sultana
natur	natural
acid	acid
spaghetti	spaghetti
giblet	giblet
sauerkraut	sauerkraut
tarragon	tarragon
sangria	sangria
bird	bird
nacho	nacho
lea	lea
leg	legs
vinegar	vinegar
great	great
greas	grease
33	33
buckwheat	buckwheat
popcorn	popcorn
mussel	mussels
maker	makers
crumpet	crumpet
liqueur	liqueur
duck	duck
cloud	cloud
lime	lime
fed	fed
rutabaga	rutabaga
doubl	double
seamless	seamless
frog	frogs
germ	germ
creol	creole
process	processed
crab	crab,crabs
pike	pike
babi	baby
rabbit	rabbit
harvest	harvest
gherkin	gherkins
broth	broth
codfish	codfish
salad	salad
chianti	chianti
superfin	superfine
pour	poured
thin	thin
peko	pekoe
crocker	crocker
bittersweet	bittersweet
tap	tap
cornflak	cornflake,cornflakes
slim	slim
high	high
carrot	carrots
shrimp	shrimp
skirt	skirt
rape	rape
lamb	lamb,lambs
rhubarb	rhubarb
trumpet	trumpet
forest	forest
feta	feta
stock	stock
jiffi	jiffy
kohlrabi	kohlrabi
cardamom	cardamom
act	acting
taco	taco
glucos	glucose
marrow	marrow
tomato	tomatoes
light	light
bing	bing
refri	refried
thigh	thigh,thighs
passion	passion
hock	hock,hocks
butternut	butternut
superior	superior
lb	lb
la	la
lo	lo
walnut	walnuts
vital	vital
madra	madras
ricotta	ricotta
spot	spot
baguett	baguette
greater	greater
frond	fronds
flour	flour
fiesta	fiesta
stout	stout
day	day
risotto	risotto
cider	cider
rennet	rennet
globe	globe
citric	citric
mincemeat	mincemeat
brittl	brittle
lentil	lentils
artichok	artichoke,artichokes
special	specials
sauc	sauce,sauces
nondairi	nondairy
crookneck	crookneck
farm	farms
stuf	stuffing,stuffed
barley	barley
romain	romaine
red	red
clarifi	clarified
frank	franks
qua	qua
salami	salami
chartreus	chartreuse
chilli	chillies
kipper	kippered,kippers
turtl	turtle
shred	shredded
veggi	veggies
bouquet	bouquet
sack	sack
bonnet	bonnet
long	long
bologna	bologna
accent	accent
wrapper	wrappers
pancak	pancake,pancakes
liquor	liquor
boil	boiling,boiled
shell	shells,shelled
shallot	shallots
slider	slider
accompani	accompaniment
drumstick	drumstick,drumsticks
lox	lox
steel	steel
prune	prunes
bee	bee
fowl	fowl
anisett	anisette
meatbal	meatballs
tabl	table
clove	cloves
soak	soaking
min	min
lili	lily
bagel	bagels
mix	mix,mixed
coke	coke
singl	single
textur	textured
segment	segments
spici	spicy
brew	brewed
applesauc	applesauce
thicken	thickeners
nutrit	nutritional
hake	hake
hollandais	hollandaise
pinhead	pinhead
brine	brine
chicken	chicken,chickens
kraft	kraft
schnapp	schnapps
jar	jarred
creme	creme
creamer	creamer
sparkl	sparkling
bourbon	bourbon
spice	spice,spices,spiced
cube	cubes,cubed
starch	starch
beau	beau
bear	bear
bean	beans
suet	suet
gray	gray
organ	organic
nutmeg	nutmeg,nutmegs
gram	gram
noodl	noodles
powder	powder,powdered
violet	violets
torpedo	torpedo
bought	bought
cake	cake,cakes
lecithin	lecithin
key	key
instant	instant
ramp	ramps
equal	equal
kosher	kosher
tater	tater
sesam	sesame
puff	puff,puffs
marjoram	marjoram
moistur	moisture
distil	distilled
oregano	oregano
ad	added
compot	compote
yam	yams
rump	rump
everglad	everglades
bulk	bulk
hamburg	hamburger
bulb	bulb
multi	multi
plain	plain
vanilla	vanilla
ripen	ripened
agar	agar
agav	agave
wild	wild
layer	layer
ripe	ripe
squid	squid
tonic	tonic
rooster	rooster
cross	cross
inch	inch
cream	cream,creamed
balm	balm
ball	balls
swordfish	swordfish
drink	drink
coffe	coffee
countri	country
dust	dusting
broccoli	broccoli
center	center
celeri	celery
i	i
well	well
jelli	jelly
poultri	poultry
kiss	kisses
rocket	rocket
flesh	fleshed
kirsch	kirsch
laurel	laurel
paddi	paddy
rapid	rapid
tawni	tawny
unbleach	unbleached
bell	bell,bells
smith	smith
lake	lakes
crack	cracked
persimmon	persimmons
smart	smart
cantaloup	cantaloupe
marzipan	marzipan
piec	pieces
five	five
press	pressed
crisp	crisp,crisps
onion	onion,onions
cutlet	cutlets
soft	soft
sourdough	sourdough
candi	candied,candy
lager	lager
limead	limeade
hair	hair
husk	husks
rapese	rapeseed
home	home
meatloaf	meatloaf
leaf	leaf
broad	broad
miner	mineral
leav	leaves
trout	trout
pepper	pepper,peppers,peppered
snapper	snappers
pasta	pasta
jam	jam
cranberri	cranberries,cranberry
biscuit	biscuits
flake	flakes,flaked
fudg	fudge
citron	citron
tenderloin	tenderloin,tenderloins
cocoa	cocoa
lettuc	lettuce,lettuces
bicarbon	bicarbonate
wildflow	wildflower
custard	custard
tamal	tamales
val	val
caviar	caviar
spiral	spiral
appl	apple,apples
saltpet	saltpeter
chunk	chunks
gluten	gluten
shank	shank,shanks
granni	granny
brand	brand
porterhous	porterhouse
neutral	neutral
bun	buns
bratwurst	bratwurst
grate	grated,grating
ear	ear,ears
eat	eating
bud	buds
pansi	pansies
made	made
veget	vegetable,vegetables
wish	wish
smooth	smooth
pippin	pippin
garbanzo	garbanzo,garbanzos
condiment	condiments
cordial	cordial
sirloin	sirloin
domino	domino
pie	pie,pies
pig	pig
twist	twists
pit	pitted
cashew	cashews
43	43
40	40
oat	oats
vermouth	vermouth
pineappl	pineapple,pineapples
star	star
breadcrumb	breadcrumbs
calabash	calabash
provolon	provolone
caper	capers
undilut	undiluted
pilaf	pilaf
frankfurt	frankfurters
liver	livers
